49 49 49 49 49 49 49 49 49 49 49 49 49 49 49 49 49 49 49 49 49 49 49 49 49 49 49 49 49 49 49 49 49 49 49 49 49 49 49 49 49 49 49 49 49 49 49 49 49 49
49 10 10 10 10 10 1 10 10 1 1 1 10 1 1 10 10 10 10 10 1 10 10 10 10 10 10 10 1 1 10 10 10 10 10 10 10 10 10 10 10 10 10 10 10 10 10 10 10 49
49 10 1 1 1 10 10 10 10 10 10 10 10 10 10 10 10 10 10 10 10 10 10 10 10 1 10 10 10 10 10 10 10 10 10 10 10 10 1 10 10 10 10 10 1 1 10 10 10 49
49 10 10 10 10 10 10 10 10 10 10 10 10 10 10 1 1 10 10 10 10 10 1 10 10 10 10 10 10 10 10 1 10 10 10 10 10 10 10 10 10 10 10 10 10 10 10 10 10 49
49 10 10 10 10 10 10 10 10 10 1 10 10 10 10 10 10 10 10 10 10 10 10 10 10 10 10 10 10 10 10 10 10 10 10 10 10 10 10 10 10 10 10 10 10 10 10 10 10 49
49 10 1 10 10 1 10 1 10 10 10 10 1 1 1 10 1 1 1 1 10 1 1 10 10 10 1 10 1 10 1 1 10 10 10 1 1 1 10 1 1 10 1 1 10 10 10 10 10 49
49 1 0 1 1 6 1 6 1 10 10 1 0 10 0 1 0 0 0 6 1 0 0 1 1 1 0 1 0 1 6 0 1 1 1 0 6 0 1 6 6 1 0 0 1 1 10 10 10 49
49 0 0 0 6 0 0 0 0 1 1 0 6 1 0 0 0 6 6 0 0 6 0 0 0 0 0 0 0 0 0 0 0 0 0 0 0 0 0 0 0 0 0 0 0 0 1 1 10 49
49 0 4 4 0 0 0 0 0 0 0 0 0 0 0 0 0 0 0 0 0 0 0 0 0 0 0 0 0 4 4 4 0 4 4 4 0 0 0 0 0 0 0 4 4 4 0 6 10 49
49 0 4 6 4 4 0 6 0 0 0 0 0 0 0 0 0 0 0 4 4 4 4 4 0 0 0 0 0 0 0 0 0 0 0 0 10 10 10 10 10 10 10 0 10 0 0 0 10 49
49 0 4 4 4 4 0 0 4 0 0 4 0 0 0 0 0 0 4 4 4 0 0 0 0 0 0 0 4 4 0 0 0 0 0 10 10 10 10 10 10 10 10 10 1 6 0 0 10 49
49 0 4 4 4 4 4 4 4 0 4 0 0 0 0 0 4 0 4 4 4 0 4 0 0 0 0 0 0 0 0 0 0 0 0 1 10 10 10 10 10 10 10 1 10 0 0 0 1 49
49 0 4 4 4 4 4 4 4 4 4 0 0 0 0 0 0 0 6 4 4 0 0 0 0 0 0 0 0 0 0 0 2 2 10 10 10 10 10 10 10 10 10 0 1 0 0 0 0 49
49 0 4 4 6 6 4 4 4 0 0 0 10 10 0 4 4 0 0 0 0 0 0 6 0 0 0 0 0 2 2 2 2 2 1 10 10 10 10 10 10 10 10 10 6 0 0 0 6 49
49 10 10 10 10 10 10 4 0 10 10 10 10 10 0 6 6 10 10 10 0 0 10 10 0 6 6 0 0 2 2 2 2 0 0 1 10 1 10 10 10 10 1 1 0 0 0 0 6 49
49 10 10 1 10 10 10 10 10 10 10 1 10 10 10 10 10 1 1 10 10 6 1 1 10 10 10 10 10 10 10 10 0 0 0 0 1 0 1 1 10 1 10 0 0 0 4 0 6 49
49 10 10 10 10 10 0 2 2 10 10 10 10 10 10 10 10 10 10 10 10 0 10 10 10 1 10 10 10 10 10 10 0 0 0 0 0 0 6 6 1 0 1 0 0 0 4 0 0 49
49 1 1 10 10 10 10 10 10 10 10 10 10 10 10 10 1 10 0 10 10 10 1 10 10 0 10 10 10 10 1 1 0 0 6 6 6 0 0 0 0 0 0 0 0 0 0 0 6 49
49 10 10 10 10 10 10 10 10 10 10 10 1 1 1 1 10 10 10 1 1 1 10 10 10 10 10 10 10 1 0 0 0 0 0 0 0 0 6 0 0 0 0 0 0 0 0 0 10 49
49 10 10 10 10 1 1 10 1 10 1 1 0 6 6 0 10 1 1 10 10 10 1 1 10 10 10 10 1 10 0 6 6 0 0 0 0 0 0 0 0 0 0 0 0 0 0 0 1 49
49 1 10 10 1 10 0 1 10 1 10 10 10 10 10 0 1 6 6 1 1 10 10 0 10 1 1 1 0 1 0 0 0 0 0 4 4 0 0 4 4 0 0 0 0 0 4 0 10 49
49 6 1 10 0 1 6 10 10 0 1 1 1 1 1 0 0 0 6 6 0 1 1 10 1 10 10 10 0 0 0 0 0 0 0 4 4 4 4 0 4 0 10 0 0 0 4 0 6 49
49 0 0 1 6 6 10 10 1 0 0 0 0 0 0 0 0 0 0 0 0 0 0 1 6 1 1 1 0 0 0 0 0 0 0 0 4 0 4 4 4 0 1 0 0 0 0 0 10 49
49 0 6 0 0 0 1 1 0 0 0 0 0 6 0 0 0 0 0 0 0 0 0 0 6 6 0 0 0 0 0 0 0 0 0 4 4 4 4 4 6 0 0 0 0 0 10 0 10 49
49 6 2 0 0 0 0 0 2 0 0 0 0 0 0 0 0 0 0 0 0 0 0 0 0 0 0 0 0 0 0 0 0 0 0 0 4 4 4 4 0 0 0 0 10 0 1 10 10 49
49 6 0 0 0 0 0 0 0 0 0 0 0 0 0 0 0 0 0 0 6 0 0 0 0 0 0 0 0 4 0 0 0 0 0 4 4 4 4 0 0 0 0 0 1 10 10 10 10 49
49 0 0 2 2 2 2 0 0 2 2 2 0 0 0 0 4 4 4 4 4 4 4 0 0 0 0 0 0 0 0 0 0 0 0 0 0 0 0 0 0 0 10 10 6 1 10 1 10 49
49 0 6 2 2 2 2 2 0 0 0 0 0 0 4 0 4 4 0 0 4 4 4 4 4 0 0 0 0 0 0 0 0 0 0 6 0 0 6 0 0 0 1 1 0 0 10 10 10 49
49 6 0 2 2 2 2 2 0 0 0 0 0 0 4 4 4 4 4 4 4 4 4 4 4 0 0 0 0 0 0 6 6 6 0 0 0 0 6 6 0 0 0 6 10 10 10 10 10 49
49 0 0 0 0 2 0 2 0 0 0 0 0 0 0 0 0 0 0 0 0 10 10 10 10 10 10 10 10 10 10 10 10 10 10 10 10 10 10 10 10 10 10 10 10 10 10 10 10 49
49 0 0 0 0 0 0 0 0 0 0 0 0 0 0 0 0 0 0 10 10 10 10 10 10 10 10 10 10 10 10 10 10 10 10 10 10 10 10 1 10 10 10 10 10 10 10 10 10 49
49 10 10 0 0 4 0 4 4 4 0 0 0 0 0 6 6 0 0 1 1 1 10 10 1 1 1 10 10 10 10 1 1 1 1 10 10 10 10 10 1 10 10 10 10 1 10 10 1 49
49 10 10 10 4 4 4 0 0 4 0 0 0 0 0 0 0 0 10 10 10 10 10 10 10 10 10 1 10 10 10 10 10 10 10 10 10 10 10 10 10 10 10 10 10 10 10 10 0 49
49 10 10 10 10 4 0 0 4 4 0 0 0 0 0 0 0 0 1 1 10 10 10 10 10 10 10 10 10 10 10 10 10 10 10 10 10 10 10 10 10 10 10 10 10 10 10 1 10 49
49 1 1 10 1 4 4 4 0 4 4 4 0 0 0 0 0 0 0 0 1 10 10 10 10 10 10 10 10 10 1 1 1 1 10 10 10 10 10 10 10 10 10 10 10 10 10 0 1 49
49 6 0 1 4 0 4 4 4 6 4 0 0 0 0 0 6 0 6 0 10 10 10 10 10 1 1 1 1 1 0 6 0 10 10 10 1 1 1 1 1 10 10 10 1 10 10 6 10 49
49 0 6 0 4 4 4 0 4 4 4 4 0 0 0 0 0 6 0 0 1 1 1 1 1 6 6 0 0 0 10 0 0 1 1 1 10 6 6 0 6 1 1 1 6 1 1 10 10 49
49 0 0 6 6 4 4 0 4 4 4 0 0 0 0 0 0 0 0 0 0 6 0 0 0 0 6 6 0 0 1 0 6 6 6 0 1 0 0 0 0 0 0 0 0 0 0 10 10 49
49 6 0 0 0 2 0 0 0 0 0 0 0 0 2 0 0 0 0 0 0 0 0 0 0 0 0 0 0 0 0 0 0 0 0 0 0 0 0 0 0 0 0 0 0 0 10 10 10 49
49 6 0 2 2 2 2 0 0 2 2 2 2 2 0 0 0 0 0 0 4 4 4 4 4 4 0 0 4 4 0 0 0 0 0 0 0 0 0 0 0 0 6 6 0 6 1 10 10 49
49 0 2 2 2 2 2 2 0 2 2 2 2 2 0 0 0 0 4 4 4 4 4 0 0 4 4 4 0 0 0 0 0 0 4 4 0 0 0 4 4 4 4 0 0 0 10 1 10 49
49 0 0 2 2 2 2 2 2 2 2 2 2 2 2 0 0 0 4 4 4 4 4 0 0 0 4 4 4 4 4 4 0 0 4 4 4 4 4 4 4 4 4 4 0 0 1 6 1 49
49 6 2 2 2 2 2 2 2 2 2 2 2 2 0 0 0 0 0 4 0 0 4 4 4 4 4 4 4 4 4 4 0 0 0 4 4 0 0 4 4 4 4 4 0 0 0 0 4 49
49 0 2 2 2 2 2 2 2 2 2 0 2 2 2 0 0 0 0 6 6 4 4 4 4 4 4 4 4 4 4 4 0 0 4 4 6 0 4 4 4 4 0 4 0 0 0 0 4 49
49 10 10 10 2 2 2 0 0 2 2 2 2 2 0 0 10 10 4 4 4 4 4 0 4 4 0 0 6 0 4 4 0 0 4 4 0 0 4 4 4 0 4 4 10 0 0 4 4 49
49 1 1 1 2 2 0 0 2 2 2 2 0 0 0 6 10 10 0 0 0 0 0 0 10 10 10 10 10 10 0 0 0 0 0 4 4 4 0 0 0 0 6 6 1 0 0 10 10 49
49 10 10 10 0 6 6 6 0 0 6 0 10 10 10 10 1 1 10 10 6 6 6 0 1 1 10 10 10 1 10 10 10 10 10 10 10 10 10 10 10 10 0 0 0 0 0 1 1 49
49 10 1 1 10 10 10 10 0 0 0 0 1 1 1 1 6 10 10 10 10 10 10 10 0 0 1 1 1 0 10 10 1 1 1 10 10 10 10 10 10 10 0 0 10 10 10 10 10 49
49 10 10 10 1 10 10 10 10 10 10 10 10 10 10 10 10 10 10 1 10 10 10 10 10 10 10 10 10 10 10 10 10 10 10 10 10 10 10 10 10 10 10 10 10 10 10 10 10 49
49 49 49 49 49 49 49 49 49 49 49 49 49 49 49 49 49 49 49 49 49 49 49 49 49 49 49 49 49 49 49 49 49 49 49 49 49 49 49 49 49 49 49 49 49 49 49 49 49 49
