49 49 49 49 49 49 49 49 49 49 49 49 49 49 49 49 49 49 49 49 49 49 49 49 49 49 49 49 49 49 49 49 49 49 49 49 49 49 49 49 49 49 49 49 49 49 49 49 49 49
49 49 49 49 49 49 49 49 49 49 49 49 49 49 49 49 49 49 49 49 49 49 49 49 49 49 49 49 49 49 49 49 49 49 49 49 49 49 49 49 49 49 49 49 49 49 49 49 49 49
49 49 49 49 49 49 49 49 49 49 49 49 49 49 49 49 49 49 49 49 49 49 49 49 49 49 49 49 49 49 49 49 49 49 49 49 49 49 49 49 49 49 49 49 49 49 49 49 49 49
49 49 49 49 49 49 49 49 49 49 49 49 49 49 49 49 49 49 49 49 49 49 49 49 49 49 49 49 49 49 49 49 49 49 49 49 49 49 49 49 49 49 49 49 49 49 49 49 49 49
49 49 49 49 49 49 49 49 49 49 49 49 49 49 49 49 49 49 49 49 49 49 49 49 49 49 49 49 49 49 49 49 49 49 49 49 49 49 49 49 49 49 49 49 49 49 49 49 49 49
49 49 49 49 49 49 49 49 49 49 49 49 49 49 49 49 49 49 49 49 49 49 49 49 49 49 49 49 49 49 49 49 49 49 49 49 49 49 49 49 49 49 49 49 49 49 49 49 49 49
49 49 49 49 49 49 49 49 49 49 49 49 49 49 49 49 49 49 49 49 49 49 49 49 49 49 49 49 49 49 49 49 49 49 35 35 49 49 49 49 49 49 49 49 49 49 49 49 49 49
49 49 49 49 49 49 49 49 49 49 49 49 49 49 49 49 49 49 35 35 35 35 35 35 35 35 35 49 49 49 49 35 35 35 35 35 49 49 35 35 49 49 49 49 49 49 49 49 49 49
49 49 49 49 49 49 49 49 49 49 49 49 49 49 49 49 49 49 35 35 35 35 35 35 35 35 35 49 49 35 35 35 35 35 35 35 35 35 35 35 49 49 49 49 49 49 49 49 49 49
49 49 49 49 49 49 49 49 49 49 49 49 49 49 49 49 35 35 35 35 35 35 35 35 35 35 35 35 35 35 35 35 35 35 35 35 35 35 35 35 49 49 49 49 49 49 49 49 49 49
49 49 49 49 49 49 49 49 49 49 49 49 49 49 49 35 35 35 35 35 35 35 35 35 35 35 35 35 35 35 35 35 35 35 35 35 35 35 35 35 35 49 49 49 49 49 49 49 49 49
49 49 49 49 49 49 35 35 35 49 49 49 49 49 49 35 35 35 35 35 35 35 35 35 35 35 35 35 35 35 35 35 35 35 35 35 35 35 35 35 35 35 49 35 49 49 49 49 49 49
49 35 35 35 35 35 35 35 35 35 35 35 35 35 35 35 35 35 35 35 35 35 35 35 35 35 35 35 35 35 35 35 35 35 35 35 35 35 35 35 35 35 35 35 49 49 49 49 49 49
49 35 35 35 35 35 35 35 35 35 35 35 35 35 35 35 35 35 35 35 35 35 35 35 35 35 35 35 35 35 35 35 35 35 35 35 34 35 35 35 35 35 35 35 49 49 49 49 49 49
49 35 35 35 35 35 35 35 35 35 35 35 35 35 35 34 34 34 34 35 35 35 35 35 35 35 35 35 35 35 35 34 34 34 34 34 31 34 35 35 35 35 35 35 35 35 49 49 49 49
49 35 35 35 35 35 34 34 34 35 35 35 35 35 35 31 31 31 31 34 34 34 34 34 34 34 34 34 34 34 34 31 31 31 31 31 31 31 34 34 34 35 35 35 35 35 49 49 49 49
49 34 34 34 34 34 31 31 31 34 34 34 34 34 34 31 31 32 31 31 31 31 31 31 31 31 31 31 30 31 31 31 31 31 31 31 31 31 31 31 31 34 35 35 35 35 49 49 49 49
49 31 31 31 31 31 31 31 31 31 31 31 31 31 31 31 31 31 31 31 31 31 31 31 31 31 32 31 31 31 31 31 31 31 31 31 31 31 31 31 33 31 34 35 35 35 49 49 49 49
49 30 30 30 30 30 30 30 30 30 30 30 30 30 30 30 30 30 30 30 30 30 30 30 30 30 30 30 31 30 30 30 30 31 31 31 31 31 31 31 31 31 31 34 35 35 49 49 49 49
49 30 30 30 30 30 30 30 30 30 30 30 30 30 30 30 30 30 30 30 30 30 30 30 30 30 30 30 30 30 30 30 30 30 31 33 31 31 31 32 31 31 31 31 34 34 35 49 49 49
49 30 30 30 30 31 31 30 30 30 30 31 30 30 30 30 30 31 31 31 30 30 49 30 30 31 31 30 30 30 30 30 30 30 31 31 31 31 31 31 31 31 31 31 31 31 35 35 49 49
49 49 49 49 49 49 49 49 49 49 49 49 49 49 49 49 49 31 31 31 31 31 49 49 31 31 31 31 31 31 30 30 30 30 31 31 31 32 31 31 31 31 31 31 31 31 35 35 49 49
49 49 49 49 49 49 49 49 49 49 49 49 49 49 49 49 49 31 31 31 31 31 35 35 31 31 31 31 31 31 31 30 30 31 31 31 31 31 31 31 32 31 31 31 31 31 35 35 49 49
49 49 49 49 49 49 49 49 49 49 49 49 49 49 49 49 49 49 31 31 31 49 35 35 31 31 32 31 31 31 31 30 30 31 31 31 31 31 31 31 31 31 31 32 31 31 34 35 49 49
49 49 49 49 49 49 49 49 49 49 49 49 49 49 49 49 49 35 31 31 31 35 35 35 31 31 31 31 31 31 31 30 30 30 31 49 31 31 31 31 31 31 31 31 31 31 31 34 49 49
49 49 49 49 49 49 49 49 49 49 49 49 49 49 49 49 35 35 31 31 31 35 35 35 31 31 31 31 31 31 31 30 30 30 31 35 49 31 31 31 32 31 31 31 31 31 31 31 49 49
49 49 49 49 49 49 49 49 49 49 49 49 49 49 35 35 35 35 31 31 31 35 34 34 31 31 31 31 31 31 31 30 30 31 31 35 35 31 31 31 31 31 31 31 31 31 31 31 49 49
49 49 49 49 49 49 49 49 49 49 49 49 49 49 35 35 35 35 31 31 31 35 31 31 31 31 31 31 31 32 31 30 30 31 31 35 35 31 31 31 31 31 31 31 32 31 31 31 49 49
49 49 49 49 49 49 49 49 49 49 49 49 49 49 35 35 35 34 31 31 31 34 31 31 31 31 31 31 31 31 31 30 30 30 31 34 35 31 32 31 31 31 31 31 31 31 31 31 49 49
49 49 49 49 49 49 49 49 49 49 49 49 49 49 35 35 34 31 31 31 31 31 31 31 32 31 31 31 31 31 31 30 30 30 31 31 34 31 31 31 31 31 31 31 31 31 31 31 49 49
49 49 49 49 49 49 49 49 49 49 49 49 49 49 34 34 31 31 31 32 31 31 31 31 31 31 31 31 31 31 31 30 30 30 30 31 31 31 31 31 31 31 31 31 31 31 32 49 49 49
49 49 49 49 49 49 49 49 49 49 49 49 49 49 31 31 31 31 31 31 31 31 31 31 31 31 31 31 31 31 31 30 30 30 31 31 31 31 31 31 31 31 31 49 31 49 49 49 49 49
49 49 49 49 49 49 49 49 49 49 49 49 49 49 49 49 31 31 31 31 31 31 31 31 31 31 31 31 31 49 31 30 30 30 31 31 31 31 31 31 31 49 49 35 49 49 49 49 49 49
49 49 49 49 49 49 49 49 49 49 49 49 49 49 49 49 49 31 31 31 31 31 31 31 31 31 31 31 31 35 31 30 30 30 31 31 31 31 31 31 31 35 35 35 49 49 49 49 49 49
49 49 49 49 49 49 49 49 49 49 49 49 49 49 49 49 49 31 31 31 31 31 31 32 31 31 31 31 31 35 31 30 30 30 31 31 31 31 31 31 31 35 35 35 49 49 49 49 49 49
49 49 49 49 49 49 49 49 49 49 49 49 49 49 49 49 35 31 31 31 31 31 31 31 31 31 31 31 31 35 31 30 30 30 31 32 31 31 31 31 34 35 35 34 49 49 49 49 49 49
49 49 49 49 49 35 35 35 35 35 35 35 35 35 35 35 35 31 31 31 31 31 31 31 31 31 31 31 31 34 31 30 30 30 31 31 31 31 31 31 31 34 34 34 35 49 49 49 49 49
49 49 49 49 49 35 35 35 35 35 35 35 35 35 35 35 35 31 31 31 31 31 31 31 31 31 31 31 31 31 31 30 30 31 31 31 31 31 31 31 32 31 31 31 35 49 49 49 49 49
49 49 49 49 49 35 35 35 35 35 35 35 35 35 35 35 35 31 31 31 31 31 31 31 31 31 33 31 31 31 31 30 30 30 31 31 31 31 31 31 31 31 31 31 35 49 49 49 49 49
49 49 49 49 49 35 35 35 35 35 35 35 35 35 35 35 34 31 31 31 31 31 31 31 31 31 31 31 31 31 31 30 30 30 31 31 31 49 49 49 31 31 33 31 35 49 49 49 49 49
49 49 49 49 49 34 34 34 34 34 34 34 34 34 34 34 31 31 31 31 32 31 31 31 49 49 31 31 31 31 31 30 30 30 31 31 31 35 49 49 49 31 31 31 34 49 49 49 49 49
49 49 49 49 49 31 31 31 31 31 31 31 31 31 31 31 31 31 31 31 31 31 31 31 35 35 49 31 31 33 31 31 30 30 31 31 31 35 35 35 35 31 31 31 31 49 49 49 49 49
49 49 49 49 49 49 49 49 49 49 49 49 49 49 49 49 49 49 49 49 31 31 31 31 35 35 35 31 31 31 31 30 30 31 31 31 31 35 35 35 35 31 31 49 49 49 49 49 49 49
49 49 49 49 49 49 49 49 49 49 49 49 49 49 49 49 49 49 49 49 49 49 49 49 35 35 35 31 31 31 31 30 30 30 31 32 31 34 35 35 35 49 49 49 49 49 49 49 49 49
49 49 49 49 49 49 49 49 49 49 49 49 49 49 49 49 49 49 49 49 49 49 49 49 34 34 35 31 33 31 31 30 30 30 31 31 31 31 34 34 34 49 49 49 49 49 49 49 49 49
49 49 49 49 49 49 49 49 49 49 49 49 49 49 49 49 49 49 49 49 49 49 49 49 49 49 49 49 49 49 49 30 30 30 49 49 49 49 49 49 49 49 49 49 49 49 49 49 49 49
49 49 49 49 49 49 49 49 49 49 49 49 49 49 49 49 49 49 49 49 49 49 49 49 49 49 49 49 49 49 35 30 30 30 35 49 49 49 49 49 49 49 49 49 49 49 49 49 49 49
49 49 49 49 49 49 49 49 49 49 49 49 49 49 49 49 49 49 49 49 49 49 49 49 49 49 49 49 49 35 35 30 30 30 35 49 49 49 49 49 49 49 49 49 49 49 49 49 49 49
49 49 49 49 49 49 49 49 49 49 49 49 49 49 49 49 49 49 49 49 49 49 49 49 49 49 49 49 49 35 35 30 4 30 35 49 49 49 49 49 49 49 49 49 49 49 49 49 49 49
49 49 49 49 49 49 49 49 49 49 49 49 49 49 49 49 49 49 49 49 49 49 49 49 49 49 49 49 49 49 49 49 49 49 49 49 49 49 49 49 49 49 49 49 49 49 49 49 49 49
