49 49 49 49 49 49 49 49 49 49 49 49 49 49 49 49 49 49 49 49 49 49 49 49 49 49 49 49 49 49 49 49 49 49 49 49 49 49 49 49 49 49 49 49 49 49 49 49 49 49
49 49 49 49 49 49 49 49 49 49 49 49 49 49 49 49 49 49 49 49 49 49 49 49 49 49 49 49 49 49 49 49 49 49 49 49 49 49 49 49 49 49 49 49 49 49 49 49 49 49
49 49 49 49 49 49 49 49 49 49 49 49 49 49 49 49 49 49 49 49 49 49 49 49 49 49 49 49 49 49 49 49 49 49 49 49 49 49 49 49 49 49 49 49 49 49 49 49 49 49
49 49 49 49 49 49 49 49 49 49 49 49 49 49 49 49 49 49 49 49 49 49 49 49 49 49 49 49 49 49 49 49 49 49 49 49 49 49 49 49 49 49 49 49 49 49 49 49 49 49
49 49 49 49 49 49 49 49 49 49 49 49 49 49 49 49 49 35 35 35 35 35 35 35 35 35 35 35 35 35 49 49 49 49 49 49 49 49 49 49 49 49 49 49 49 49 49 49 49 49
49 49 49 49 49 49 49 49 49 49 49 49 49 49 49 49 35 35 35 35 35 35 35 35 35 35 35 35 35 35 49 49 49 49 49 49 49 49 49 49 49 49 49 49 49 49 49 49 49 49
49 49 49 49 49 49 49 49 49 49 49 49 49 49 49 35 35 35 35 35 35 35 35 35 35 35 35 35 35 35 35 35 49 49 49 49 49 49 49 49 49 49 49 49 49 49 49 49 49 49
49 49 49 49 49 49 49 49 49 49 49 49 49 35 35 35 35 35 35 35 35 35 35 35 35 35 35 35 35 35 35 35 35 35 35 35 49 49 49 49 49 49 49 49 49 49 49 49 49 49
49 49 49 49 49 49 49 49 49 49 49 49 35 35 35 35 35 34 34 34 34 34 34 34 34 34 34 34 34 34 35 35 35 35 35 35 49 49 49 49 49 49 49 49 49 49 49 49 49 49
49 49 49 49 49 49 49 49 49 49 49 49 35 35 35 35 34 11 11 11 11 11 11 11 11 11 11 11 11 11 35 35 35 35 35 35 49 49 49 49 49 49 49 49 49 49 49 49 49 49
49 49 49 49 49 49 49 49 49 49 49 49 35 35 35 34 11 11 11 11 11 11 11 11 11 11 11 11 11 11 34 34 35 35 35 35 49 49 49 49 49 49 49 49 49 49 49 49 49 49
49 49 49 49 49 49 49 49 49 49 49 49 35 34 34 11 11 11 11 11 11 11 11 11 11 11 11 11 11 11 11 11 34 34 34 34 49 49 49 49 49 49 49 49 49 49 49 49 49 49
49 49 49 49 49 49 49 49 49 49 49 35 34 31 11 11 11 11 11 11 11 11 11 11 11 11 11 11 11 11 11 11 11 31 31 31 49 49 49 49 49 49 49 49 49 49 49 49 49 49
49 49 49 49 49 49 49 49 49 49 49 35 31 31 31 11 11 11 11 11 11 11 11 11 11 11 11 11 11 11 11 11 31 31 31 31 49 49 49 49 49 49 49 49 49 49 49 49 49 49
49 49 49 49 49 49 49 49 49 49 35 35 31 31 31 11 11 11 11 11 11 11 11 11 11 11 11 11 11 11 11 11 31 31 31 31 49 49 49 49 49 49 49 49 49 49 49 49 49 49
49 35 35 35 35 35 35 35 35 35 35 35 31 31 31 11 11 11 11 11 11 11 11 11 11 11 11 11 11 11 11 11 31 31 31 31 35 49 49 49 49 49 49 49 49 49 49 49 49 49
49 35 35 35 35 35 35 35 35 35 35 34 31 31 31 11 11 11 11 11 11 11 11 11 11 11 11 11 11 11 11 11 31 31 31 31 35 35 49 49 49 49 49 49 49 49 49 49 49 49
49 35 35 35 35 35 35 35 35 35 35 31 31 31 31 11 11 11 11 11 11 11 11 11 31 31 31 31 31 31 31 31 31 31 31 31 35 35 35 35 35 49 49 49 49 49 49 49 49 49
49 35 35 35 35 35 35 35 35 35 34 31 31 31 31 11 11 11 11 11 11 11 11 11 31 31 31 31 31 31 31 31 31 31 31 31 35 35 35 35 35 35 49 49 49 49 49 49 49 49
49 34 34 34 34 34 34 34 34 34 31 31 31 31 31 31 31 31 30 30 30 31 31 31 31 31 31 31 31 31 31 31 31 31 31 31 34 35 35 35 35 35 49 49 49 49 49 49 49 49
49 30 30 30 30 30 30 30 30 30 31 31 31 31 31 31 31 31 30 30 30 31 31 31 31 31 31 31 31 31 31 31 31 31 31 31 31 34 35 35 35 35 49 49 49 49 49 49 49 49
49 30 30 30 30 30 30 30 30 30 30 30 31 31 31 31 31 31 30 30 30 31 31 31 31 30 30 30 30 30 30 30 30 30 30 30 30 30 34 34 34 35 49 49 49 49 49 49 49 49
49 30 30 30 30 30 30 30 30 30 30 30 30 31 31 31 31 30 30 30 30 31 31 30 30 30 30 30 30 30 30 30 30 30 30 30 30 30 30 31 31 34 49 49 49 49 49 49 49 49
49 31 49 31 49 31 30 30 30 30 30 30 30 30 31 31 31 30 30 30 30 30 30 30 30 30 30 30 30 30 30 30 30 30 30 30 30 30 30 30 31 31 49 49 49 49 49 49 49 49
49 49 49 49 49 49 31 31 49 30 30 30 30 30 30 30 30 30 30 30 30 30 30 30 30 30 30 30 30 30 30 30 30 30 30 30 30 30 30 30 31 31 49 49 49 49 49 49 49 49
49 49 49 49 49 49 49 49 49 30 30 30 30 30 30 30 30 30 30 30 30 30 30 30 30 30 30 30 30 30 30 30 30 31 31 30 30 30 30 30 31 31 49 49 49 49 49 49 49 49
49 49 49 49 49 49 49 49 49 31 31 30 30 30 30 30 30 30 30 30 30 30 30 30 30 30 30 30 30 30 30 30 30 31 31 30 30 30 30 30 31 31 49 49 49 49 49 49 49 49
49 49 49 49 49 49 49 49 49 49 31 30 30 30 30 30 30 30 30 30 30 30 30 30 30 30 30 30 30 30 30 30 30 30 30 30 30 30 30 30 31 31 35 49 49 49 49 49 49 49
49 49 49 49 49 49 49 49 49 49 49 49 30 30 30 30 30 30 30 30 30 30 30 30 30 30 30 30 30 30 30 30 30 30 30 30 30 30 30 30 30 31 35 49 49 49 49 49 49 49
49 49 49 49 49 49 49 49 49 49 49 49 31 31 31 31 31 31 31 30 30 30 30 30 30 30 31 31 31 30 30 30 30 30 30 30 30 30 30 30 30 31 35 49 49 49 49 49 49 49
49 49 49 49 49 49 49 49 49 49 49 49 49 49 49 49 49 49 31 31 31 30 30 30 30 30 31 31 49 49 30 30 30 30 30 30 49 30 30 30 30 31 35 49 49 49 49 49 49 49
49 49 49 49 49 49 49 49 49 49 49 49 49 49 49 49 49 49 49 31 31 30 30 30 30 30 31 31 35 49 49 49 49 49 49 49 49 30 30 30 31 31 34 49 49 49 49 49 49 49
49 49 49 49 49 49 49 49 49 49 49 49 49 49 49 49 49 49 49 49 31 31 30 30 30 30 31 31 35 35 49 49 49 49 49 49 49 49 49 49 49 49 49 49 49 49 49 49 49 49
49 49 49 49 49 49 49 49 49 49 49 49 49 49 49 49 49 49 49 49 31 31 30 30 30 30 31 31 35 35 35 35 49 49 49 49 49 49 49 49 49 49 49 49 49 49 49 49 49 49
49 49 49 49 49 49 49 49 49 49 49 49 49 49 49 49 49 49 49 49 49 31 30 30 30 30 31 31 35 35 35 35 49 35 49 49 49 49 49 49 49 49 49 49 49 49 49 49 49 49
49 49 49 49 49 49 49 49 49 49 49 49 49 49 49 49 49 49 49 49 49 31 30 30 30 30 30 31 34 35 35 35 35 35 49 49 49 49 49 49 49 49 49 49 49 49 49 49 49 49
49 49 49 49 49 49 49 49 49 49 49 49 49 49 49 49 49 49 49 49 49 31 30 30 30 30 30 31 31 34 35 35 35 35 35 49 49 49 49 49 49 49 49 49 49 49 49 49 49 49
49 49 49 49 49 49 49 49 49 49 49 49 49 49 49 49 49 49 49 49 49 31 30 30 30 30 30 31 31 31 34 34 35 35 35 35 49 49 49 49 49 49 49 49 49 49 49 49 49 49
49 49 49 49 49 49 49 49 49 49 49 49 49 49 49 49 49 49 49 49 49 31 30 30 30 30 30 30 31 31 31 31 35 34 35 35 35 35 49 49 49 49 49 49 49 49 49 49 49 49
49 49 49 49 49 49 49 49 49 49 49 49 49 49 49 49 49 49 49 49 49 31 31 30 30 30 30 30 30 30 30 30 34 31 35 35 35 35 49 49 49 49 49 49 49 49 49 49 49 49
49 49 49 49 49 49 49 49 49 49 49 49 49 49 49 49 49 49 49 49 49 31 31 30 30 30 30 30 30 30 30 30 30 31 34 35 35 35 49 49 49 49 49 49 49 49 49 49 49 49
49 49 49 49 49 49 49 49 49 49 49 49 49 49 49 49 49 49 49 49 49 49 31 31 30 30 30 30 30 30 30 30 30 30 31 34 35 35 49 49 49 49 49 49 49 49 49 49 49 49
49 49 49 49 49 49 49 49 49 49 49 49 49 49 49 49 49 49 49 49 49 49 49 31 31 31 31 31 31 36 30 30 30 30 30 31 34 34 49 49 49 49 49 49 49 49 49 49 49 49
49 49 49 49 49 49 49 49 49 49 49 49 49 49 49 49 49 49 49 49 49 49 49 49 49 49 49 49 31 31 49 30 30 30 30 31 31 49 49 49 49 49 49 49 49 49 49 49 49 49
49 49 49 49 49 49 49 49 49 49 49 49 49 49 49 49 49 49 49 49 49 49 49 49 49 49 49 49 49 31 49 36 30 30 36 31 31 49 49 49 49 49 49 49 49 49 49 49 49 49
49 49 49 49 49 49 49 49 49 49 49 49 49 49 49 49 49 49 49 49 49 49 49 49 49 49 49 49 49 31 49 36 30 36 49 49 49 49 49 49 49 49 49 49 49 49 49 49 49 49
49 49 49 49 49 49 49 49 49 49 49 49 49 49 49 49 49 49 49 49 49 49 49 49 49 49 49 49 49 49 49 36 30 36 49 49 49 49 49 49 49 49 49 49 49 49 49 49 49 49
49 49 49 49 49 49 49 49 49 49 49 49 49 49 49 49 49 49 49 49 49 49 49 49 49 49 49 49 49 49 49 36 30 36 49 49 49 49 49 49 49 49 49 49 49 49 49 49 49 49
49 49 49 49 49 49 49 49 49 49 49 49 49 49 49 49 49 49 49 49 49 49 49 49 49 49 49 49 49 49 49 36 30 36 49 49 49 49 49 49 49 49 49 49 49 49 49 49 49 49
49 49 49 49 49 49 49 49 49 49 49 49 49 49 49 49 49 49 49 49 49 49 49 49 49 49 49 49 49 49 49 49 49 49 49 49 49 49 49 49 49 49 49 49 49 49 49 49 49 49
