49 49 49 49 49 49 49 49 49 49 49 49 49 49 49 49 49 49 49 49 49 49 49 49 49 49 49 49 49 49 49 49 49 49 49 49 49 49 49 49 49 49 49 49 49 49 49 49 49 49
49 49 49 49 49 49 49 49 49 49 49 49 49 49 49 49 49 49 49 49 49 49 49 49 49 49 49 49 49 49 49 49 49 49 49 49 49 49 49 49 49 11 11 11 11 11 11 11 11 49
49 49 49 49 49 49 49 49 49 49 49 49 49 49 49 49 49 49 49 49 49 49 49 49 49 49 35 35 35 35 35 35 35 35 35 35 35 35 35 11 11 11 11 11 11 11 11 11 11 49
49 49 49 49 49 49 49 49 49 49 49 49 49 49 49 49 49 49 49 49 49 49 49 49 49 35 35 35 35 35 35 35 35 35 35 35 35 35 35 11 11 11 11 11 11 11 11 11 11 49
49 49 49 49 49 49 49 49 49 49 49 49 49 49 49 49 49 49 49 35 35 35 35 35 35 35 35 35 35 35 35 35 35 35 35 35 35 35 35 11 11 11 11 11 11 11 11 11 11 49
49 49 49 49 49 49 49 49 49 49 49 49 49 49 49 49 49 49 35 35 35 35 35 35 35 35 35 35 35 35 35 35 35 35 35 35 35 35 35 11 11 11 11 11 11 11 11 11 11 49
49 49 49 49 49 49 49 49 49 49 49 35 35 35 35 35 35 35 35 35 35 35 35 35 35 35 35 35 35 35 35 35 35 35 35 35 35 11 11 11 11 11 11 11 11 11 11 11 11 49
49 49 49 49 49 49 49 49 49 49 35 35 35 35 35 35 35 35 35 35 35 35 35 35 35 35 35 35 35 35 35 35 35 35 35 35 35 11 11 11 11 11 11 11 11 11 11 11 11 49
49 49 49 49 35 35 35 35 35 35 35 35 35 35 35 35 35 35 35 35 35 35 35 35 35 35 34 34 34 34 34 34 34 34 34 34 34 11 11 11 11 11 11 11 11 11 11 11 11 49
49 49 35 35 35 35 35 35 35 35 35 35 35 35 35 35 35 35 35 35 35 35 35 35 35 34 31 31 31 31 31 31 31 31 31 31 31 11 11 11 11 11 11 11 11 11 11 11 11 49
49 49 35 35 35 35 35 35 35 35 35 35 35 35 35 35 35 35 35 34 34 34 34 34 34 31 30 30 30 30 30 30 30 30 30 30 30 30 11 11 11 11 11 11 11 11 11 11 11 49
49 49 35 35 35 35 35 35 35 35 35 35 35 35 35 35 35 35 34 31 31 31 31 31 31 30 30 30 30 30 31 31 31 31 31 31 31 31 11 11 11 11 11 11 11 11 11 11 11 49
49 49 35 35 35 35 35 35 35 35 35 34 34 34 34 34 34 34 31 30 30 30 30 30 30 30 30 31 31 31 31 32 32 32 32 32 32 32 11 11 11 11 11 11 11 11 11 11 11 49
49 49 35 35 35 35 35 35 35 35 34 31 31 31 31 31 31 31 30 30 30 30 31 31 31 31 31 31 32 32 32 33 33 33 33 33 33 33 11 11 11 11 11 11 11 11 11 11 11 49
49 49 35 35 34 34 34 34 34 34 31 30 30 30 30 30 30 30 30 30 31 31 31 32 32 32 32 32 33 33 33 49 49 49 49 49 49 49 49 49 49 49 49 49 49 49 49 49 49 49
49 49 34 34 31 31 31 31 31 31 30 30 30 30 30 30 31 31 31 31 32 32 32 33 33 33 33 33 49 49 49 49 49 49 49 49 49 49 49 49 49 49 49 49 49 49 49 49 49 49
49 49 31 31 30 30 30 30 30 30 30 30 31 31 31 31 32 32 32 32 33 33 33 49 49 49 49 49 49 49 49 49 49 49 49 49 49 49 49 49 49 49 49 49 49 49 49 49 49 49
49 49 31 31 30 30 31 31 31 31 31 31 32 32 32 32 33 33 33 33 49 49 49 49 49 49 49 49 49 49 49 49 49 49 49 49 49 49 49 49 49 49 49 49 49 49 49 49 49 49
49 49 31 30 30 30 31 32 32 32 32 32 33 33 33 33 49 49 49 49 49 49 49 49 49 49 49 49 49 49 49 49 49 49 49 49 49 49 49 49 49 49 49 49 49 49 49 49 49 49
49 49 31 30 30 30 32 33 33 33 33 33 49 49 49 49 49 49 49 49 35 35 35 49 49 49 49 49 49 49 49 49 49 49 49 49 49 49 49 49 49 49 49 49 49 49 49 49 49 49
49 49 31 30 30 30 33 49 49 49 49 49 49 49 49 49 35 35 35 35 35 35 35 35 35 35 35 35 35 49 49 49 49 49 49 49 49 49 49 49 49 49 49 49 49 49 49 49 49 49
49 49 31 30 30 30 49 49 49 49 49 49 49 49 49 35 35 35 35 35 35 35 35 35 35 35 35 35 35 35 35 49 49 49 49 49 49 49 49 49 49 49 49 49 49 49 49 49 49 49
49 49 32 31 31 30 31 31 31 31 31 31 0 49 49 34 35 35 35 35 35 35 35 35 35 35 35 35 35 35 35 35 49 49 49 49 49 49 49 49 49 49 49 49 49 49 49 49 49 49
49 49 49 32 31 0 31 30 30 30 30 30 4 31 31 31 34 34 34 34 34 34 35 35 35 35 35 35 35 35 35 35 35 49 49 49 49 49 49 49 49 49 49 49 49 49 49 49 49 49
49 49 49 33 32 32 32 32 32 32 0 31 31 30 4 31 31 0 0 31 31 31 34 35 35 35 35 35 35 35 35 35 35 35 49 49 49 49 49 49 49 49 49 49 49 49 49 49 49 49
49 49 49 49 33 33 33 33 33 33 32 31 0 31 31 31 31 0 30 30 4 31 0 34 34 34 34 34 34 34 34 35 35 35 35 35 10 10 49 49 49 49 49 49 49 49 49 49 49 49
49 49 49 49 49 49 49 49 49 49 33 32 0 0 32 0 0 32 0 31 31 4 31 0 31 31 31 0 0 0 0 34 34 34 34 34 34 1 10 49 49 49 49 49 49 49 49 49 49 49
49 49 49 49 49 49 49 49 49 49 49 33 33 33 33 33 33 33 32 0 0 0 0 30 0 31 30 4 0 4 4 0 31 0 0 0 0 0 1 10 10 10 10 10 10 49 49 49 49 49
49 49 49 49 49 49 49 49 49 49 49 49 49 49 49 49 49 49 33 32 32 0 32 32 31 0 0 32 0 31 0 0 4 4 30 31 4 0 0 1 1 1 1 1 1 10 49 49 49 49
49 49 49 49 49 49 49 49 49 49 49 49 49 49 49 49 49 49 49 33 33 10 10 10 10 10 10 10 32 32 0 0 0 0 0 0 4 4 0 0 0 0 0 0 0 1 10 49 49 49
49 49 49 49 49 49 49 49 49 49 49 49 49 49 49 49 49 49 49 49 49 49 49 10 1 1 10 10 10 10 10 10 10 10 32 0 0 0 0 30 30 0 4 0 31 0 1 49 49 49
49 49 49 49 49 49 49 49 49 49 49 49 49 49 49 49 10 10 10 10 49 49 49 49 10 10 10 1 10 10 1 10 10 10 10 10 10 10 10 10 10 0 0 30 0 0 0 49 49 49
49 49 49 49 49 49 49 49 49 49 49 49 49 49 49 49 10 1 10 49 49 49 10 10 10 10 10 10 10 10 10 10 10 10 10 10 10 10 10 10 10 0 0 4 0 0 0 49 49 49
49 49 49 49 49 49 49 49 49 49 49 49 49 49 10 10 10 10 1 10 10 10 10 10 1 10 10 10 10 10 10 10 1 1 1 1 1 1 1 1 1 6 0 4 0 0 0 49 49 49
49 49 49 10 10 10 10 10 10 10 10 10 10 10 1 1 1 10 10 10 10 10 10 10 10 10 10 10 10 10 10 1 0 0 0 0 0 0 0 0 0 0 30 0 0 0 0 49 49 49
49 49 10 10 10 10 10 10 10 10 10 10 10 10 10 10 10 10 10 10 10 10 10 10 10 1 1 1 1 1 1 6 0 0 4 4 0 4 0 0 4 0 0 0 0 0 10 49 49 49
49 49 10 10 10 1 1 1 1 10 10 10 10 10 10 10 10 1 1 1 1 1 1 1 1 6 0 0 0 0 0 4 0 4 0 0 0 0 0 0 0 0 0 0 0 10 10 49 49 49
49 49 10 10 10 10 10 10 10 10 10 1 1 1 1 1 1 0 0 6 6 0 0 0 0 0 0 4 4 0 0 4 31 0 0 0 10 10 10 10 10 10 10 10 10 10 10 49 49 49
49 49 1 10 10 10 10 10 10 10 1 6 6 6 0 0 0 4 0 0 4 4 0 0 0 4 0 0 0 0 0 0 0 0 0 10 10 10 1 10 10 10 10 10 10 10 49 49 49 49
49 49 10 10 1 1 1 1 1 1 0 0 0 0 4 0 0 4 0 0 0 0 0 0 0 0 0 0 0 10 10 10 10 10 10 10 10 10 10 10 10 10 10 10 10 49 49 49 49 49
49 49 10 1 0 6 6 6 6 0 4 4 0 0 0 0 0 0 0 0 0 10 10 10 10 10 10 10 10 10 10 10 10 10 10 10 1 49 49 49 49 49 49 49 49 49 49 49 49 49
49 49 1 6 4 0 4 0 0 0 4 0 0 0 0 6 6 6 6 6 6 10 10 10 10 10 10 1 10 10 10 10 1 1 10 10 49 49 49 49 49 49 49 49 49 49 49 49 49 49
49 0 0 0 4 0 0 0 0 0 0 0 0 0 6 10 10 10 10 10 10 10 1 10 10 10 10 10 10 49 49 49 49 49 49 49 49 49 49 49 49 49 49 49 49 49 49 49 49 49
49 4 4 4 0 0 0 0 10 10 6 6 6 6 10 10 10 10 10 10 10 10 49 49 49 49 49 49 49 49 49 49 49 49 49 49 49 49 49 49 49 49 49 49 49 49 49 49 49 49
49 0 0 0 0 0 0 10 10 10 10 10 10 10 10 10 10 10 10 10 10 49 49 49 49 49 49 49 49 49 49 49 49 49 49 49 49 49 49 49 49 49 49 49 49 49 49 49 49 49
49 49 6 6 6 6 6 10 10 10 1 1 10 1 10 49 49 49 49 49 49 49 49 49 49 49 49 49 49 49 49 49 49 49 49 49 49 49 49 49 49 49 49 49 49 49 49 49 49 49
49 49 10 10 10 10 10 10 1 49 49 49 49 49 49 49 49 49 49 49 49 49 49 49 49 49 49 49 49 49 49 49 49 49 49 49 49 49 49 49 49 49 49 49 49 49 49 49 49 49
49 49 10 10 1 10 10 1 49 49 49 49 49 49 49 49 49 49 49 49 49 49 49 49 49 49 49 49 49 49 49 49 49 49 49 49 49 49 49 49 49 49 49 49 49 49 49 49 49 49
49 49 49 49 49 49 49 49 49 49 49 49 49 49 49 49 49 49 49 49 49 49 49 49 49 49 49 49 49 49 49 49 49 49 49 49 49 49 49 49 49 49 49 49 49 49 49 49 49 49
49 49 49 49 49 49 49 49 49 49 49 49 49 49 49 49 49 49 49 49 49 49 49 49 49 49 49 49 49 49 49 49 49 49 49 49 49 49 49 49 49 49 49 49 49 49 49 49 49 49
