49 49 49 49 49 49 49 49 49 49 49 49 49 49 49 49 49 49 49 49 49 49 49 49 49 49 49 49 49 49 49 49 49 49 49 49 49 49 49 49 49 49 49 49 49 49 49 49 49 49
49 49 49 49 49 49 49 49 49 49 49 49 49 49 49 49 49 49 49 49 49 49 49 49 49 49 49 4 4 4 10 10 10 10 10 10 10 10 10 10 10 10 10 10 10 10 10 10 10 49
49 10 10 10 10 10 10 10 10 10 10 10 10 10 10 10 10 10 10 10 10 10 10 10 10 10 0 4 4 4 10 10 10 10 10 10 10 10 10 10 10 10 10 1 10 10 10 10 10 49
49 10 10 10 10 10 10 10 10 10 10 10 10 10 10 10 10 1 1 10 10 10 10 10 10 1 0 4 4 4 10 10 10 10 10 10 10 10 10 1 10 10 10 10 10 10 10 10 10 49
49 10 10 10 10 10 1 1 10 10 10 10 10 10 10 10 10 10 10 10 10 10 10 10 10 0 0 4 4 4 10 10 10 10 10 10 1 10 10 10 10 10 10 10 10 1 1 10 10 49
49 10 10 10 10 10 10 10 10 10 10 10 10 10 10 10 1 10 10 10 10 10 1 10 10 0 0 4 4 4 1 10 10 10 10 10 10 10 10 10 10 10 10 10 10 10 10 10 10 49
49 10 10 10 10 10 10 10 10 10 10 10 1 10 10 10 10 10 10 10 10 10 10 10 10 0 6 4 4 4 0 1 1 10 10 10 10 10 10 10 10 10 10 10 10 10 1 10 10 49
49 10 10 10 10 10 10 10 10 10 10 10 10 10 10 10 10 10 10 10 10 10 10 10 1 0 6 4 4 4 0 0 0 1 1 1 1 1 1 10 10 1 1 1 1 10 10 10 10 49
49 10 10 10 10 10 1 10 10 10 10 10 10 10 10 10 10 1 1 10 10 10 10 10 0 0 6 4 4 4 6 0 0 0 0 0 0 0 0 1 1 0 0 0 0 1 10 10 10 49
49 10 10 10 10 10 10 10 10 10 10 10 10 10 10 10 1 0 6 1 1 1 1 1 0 0 6 4 4 4 6 0 0 0 0 11 11 11 11 0 0 0 0 0 0 0 1 1 1 49
49 10 10 10 10 10 10 10 10 10 1 1 1 1 1 1 0 6 0 0 0 0 0 0 0 0 6 4 4 4 6 0 0 0 0 11 11 11 11 0 0 0 11 11 11 11 0 0 0 49
49 10 10 10 10 1 1 1 1 1 6 6 6 6 6 0 6 0 0 0 0 0 0 0 0 0 6 4 4 4 6 0 0 0 0 11 11 11 11 0 0 0 11 11 11 11 0 10 10 49
49 10 10 10 1 6 6 6 0 11 11 11 11 0 0 0 0 0 0 0 0 0 0 0 0 0 6 4 4 4 0 0 0 0 0 11 11 10 11 0 0 0 11 11 11 11 10 10 10 49
49 10 10 1 6 0 0 0 0 11 11 11 11 0 0 0 0 0 0 0 0 0 0 0 0 0 0 4 4 4 0 0 6 6 0 0 30 30 0 0 0 0 11 11 10 11 1 1 10 49
49 10 10 0 0 0 0 0 0 11 11 11 11 0 0 0 0 0 0 0 0 0 6 6 4 4 4 4 4 4 30 30 30 30 30 0 30 30 6 0 0 0 0 30 30 0 0 0 1 49
49 10 10 0 0 0 0 0 0 11 10 11 11 0 0 0 0 0 0 0 6 0 4 4 4 4 4 4 4 4 30 30 30 30 30 30 30 30 30 30 30 0 0 30 30 6 0 0 10 49
49 10 10 10 0 0 0 0 0 0 4 4 0 0 6 6 6 6 0 4 4 4 4 4 4 0 6 6 6 6 6 6 0 30 30 30 30 30 30 30 30 30 30 30 30 6 0 0 10 49
49 10 10 1 6 6 6 0 0 0 4 4 4 4 4 4 4 4 4 4 4 4 4 0 0 0 0 0 0 0 0 0 0 0 0 6 6 6 6 30 30 30 30 30 30 0 0 0 10 49
49 10 10 10 10 10 34 0 0 0 4 4 4 4 4 4 4 4 4 4 4 4 4 6 0 0 0 0 0 0 0 0 0 0 0 0 0 0 0 0 6 6 6 6 0 0 0 0 10 49
49 10 10 10 10 10 1 6 6 0 0 0 0 6 6 0 0 0 0 0 4 4 4 6 0 0 0 0 0 10 0 0 0 0 0 0 0 0 0 0 0 0 0 0 0 0 0 0 10 49
49 10 10 10 10 10 10 10 10 10 10 10 10 10 10 10 10 0 0 6 4 4 4 6 0 0 0 0 0 1 0 0 10 10 10 0 0 0 0 10 10 10 10 10 10 10 10 10 10 49
49 10 10 10 10 10 10 10 10 10 10 1 1 10 10 10 1 0 0 6 4 4 4 6 0 0 0 0 0 0 10 10 10 10 1 0 0 10 10 10 10 10 10 10 10 10 10 10 10 49
49 10 10 10 10 10 10 10 10 10 10 10 10 10 10 1 0 0 0 0 4 4 4 0 0 0 0 0 0 0 1 1 1 1 0 0 0 10 10 10 10 10 10 10 10 10 10 10 10 49
49 10 10 10 10 10 10 10 10 1 1 1 10 1 1 0 0 0 4 4 4 4 4 4 4 0 0 0 0 0 0 0 0 0 0 0 0 1 1 10 10 10 10 10 10 10 10 10 10 49
49 10 10 10 10 10 10 1 1 6 6 6 1 0 6 0 0 4 4 4 4 4 4 4 4 4 0 0 0 0 0 0 0 0 0 0 0 0 0 1 1 1 1 1 1 10 1 10 10 49
49 10 10 10 10 10 10 6 0 0 0 0 0 0 0 6 4 4 4 6 6 6 6 6 4 4 4 0 6 6 6 6 6 6 0 0 0 0 0 0 0 0 0 0 0 1 0 1 10 49
49 10 10 10 10 10 10 0 10 10 10 0 0 0 0 6 4 4 4 6 0 0 0 6 4 4 4 4 4 4 4 4 4 4 4 4 0 6 6 6 6 0 0 0 0 0 0 0 10 49
49 10 10 10 10 10 10 0 1 1 1 0 0 0 0 6 4 4 4 6 0 0 0 6 4 4 4 4 4 4 4 4 4 4 4 4 4 4 4 4 4 4 0 0 0 0 0 0 34 49
49 10 10 10 10 10 1 0 0 0 0 0 0 0 0 6 4 4 4 6 6 6 6 6 4 4 4 4 4 4 4 4 4 4 4 4 4 4 4 4 4 4 4 4 4 4 4 4 4 49
49 10 10 10 10 10 6 0 0 0 0 0 0 0 0 0 0 4 4 4 4 4 4 4 4 4 0 6 6 6 6 6 4 4 4 4 4 4 4 4 4 4 4 4 4 4 4 4 4 49
49 10 10 1 1 1 0 0 0 0 0 0 0 0 0 0 0 0 4 4 4 4 4 4 4 0 0 0 0 0 0 0 0 6 6 6 6 6 6 6 4 4 4 4 4 4 4 4 4 49
49 10 10 6 6 0 0 0 0 0 0 0 0 0 10 0 0 0 0 0 4 4 4 0 0 0 0 0 10 0 0 0 0 0 0 0 0 0 0 0 0 0 0 0 6 6 6 31 10 49
49 10 10 0 11 11 11 11 0 0 0 0 0 0 1 0 0 0 0 6 4 4 4 0 0 0 0 0 1 0 0 0 0 0 0 0 0 0 0 0 0 0 0 0 0 0 0 10 10 49
49 10 10 0 11 11 11 11 0 0 0 0 0 0 0 0 10 0 0 6 4 4 4 6 0 0 0 0 0 0 10 0 0 0 0 10 10 0 10 10 10 10 10 0 0 0 0 1 10 49
49 10 10 0 11 11 11 11 0 0 0 0 0 0 0 0 1 0 0 6 4 4 4 6 0 0 0 0 0 0 1 0 0 0 10 1 1 0 10 10 10 10 10 10 0 10 0 0 10 49
49 10 10 0 11 11 10 11 0 0 0 0 0 0 0 0 0 0 0 6 4 4 4 6 0 0 0 0 0 0 0 0 0 0 1 0 0 10 10 10 10 10 1 1 10 1 10 0 10 49
49 10 10 0 0 4 4 0 0 0 0 11 11 11 11 0 0 0 0 0 4 4 4 6 0 0 0 11 11 11 11 0 0 0 0 0 10 10 10 1 10 10 10 10 10 0 1 0 10 49
49 10 10 0 6 4 4 0 0 0 0 11 11 11 11 0 0 0 0 0 4 4 4 6 0 0 0 11 11 11 11 0 0 0 0 0 10 10 10 10 10 10 10 10 10 10 0 0 10 49
49 10 10 0 6 4 4 0 0 0 0 11 11 11 11 0 0 0 0 0 4 4 4 6 0 0 0 11 11 11 11 0 0 0 10 0 10 10 10 10 10 10 10 10 10 1 0 0 10 49
49 10 10 0 6 4 4 0 6 6 6 11 11 10 11 6 6 6 6 0 4 4 4 0 0 0 0 11 10 11 11 0 0 0 1 0 1 1 10 10 10 10 10 10 1 0 0 0 10 49
49 10 10 0 6 4 4 4 4 4 4 4 4 4 4 4 4 4 4 4 4 4 4 0 0 0 0 0 4 4 6 0 0 0 0 0 0 0 10 1 10 10 10 10 10 10 0 10 10 49
49 10 10 0 0 0 4 4 4 4 4 4 4 4 4 4 4 4 4 4 4 4 4 0 6 6 6 0 4 4 6 0 0 0 0 0 0 0 10 10 10 10 1 10 10 10 10 1 10 49
49 10 10 0 0 0 0 6 6 6 6 6 6 6 0 0 6 6 0 0 4 4 4 4 4 4 4 4 4 4 6 0 0 0 0 0 10 0 1 10 10 10 10 10 10 10 10 10 10 49
49 10 10 0 0 0 0 0 0 0 0 0 0 0 0 0 0 0 0 0 4 4 4 4 4 4 4 4 4 4 6 0 0 0 0 0 1 0 0 1 1 1 1 1 10 10 10 1 10 49
49 10 1 0 0 0 0 0 0 0 0 0 0 0 0 0 0 0 0 0 4 4 4 0 0 6 6 6 6 0 0 0 0 0 0 0 0 0 0 0 0 0 0 0 1 1 1 0 10 49
49 10 0 0 0 0 0 0 0 0 3 3 3 3 3 3 3 3 3 3 3 3 3 3 3 3 3 3 3 3 3 3 3 3 3 3 0 0 0 0 0 0 0 0 0 0 0 0 10 49
49 10 0 0 0 0 0 0 0 3 3 3 3 3 3 3 3 3 3 3 3 3 3 3 3 3 3 3 3 3 3 3 3 3 3 3 3 3 3 3 3 0 0 0 0 0 10 10 10 49
49 10 0 0 0 0 3 3 3 3 3 3 3 3 3 3 3 3 3 3 3 3 3 3 3 3 3 3 3 3 3 3 3 3 3 3 3 3 3 3 3 3 0 0 0 10 10 1 10 49
49 10 10 10 10 3 3 3 3 3 3 3 3 3 3 3 3 3 3 3 3 3 3 3 3 3 3 3 3 3 3 3 3 3 3 3 3 3 3 3 3 3 3 3 0 1 10 10 10 49
49 49 49 49 49 49 49 49 49 49 49 49 49 49 49 49 49 49 49 49 49 49 49 49 49 49 49 49 49 49 49 49 49 49 49 49 49 49 49 49 49 49 49 49 49 49 49 49 49 49
